10
10
▓▓▓▓▓▓▓▓▓▓
▓        ▓
▓        ▓
▓        ▓
▓    ▓   ▓
▓    ▓   ▓
▓    ▓▓▓ ▓
▓        ▓
▓        ▓
▓▓▓▓▓▓▓▓▓▓