15
30
▓ ▓▓▓▓▓▓▓▓▓▓▓▓▓▓▓▓▓▓▓▓▓▓▓▓▓▓ ▓
 @                            
▓▓▓▓▓▓▓▓▓▓▓▓▓▓▓▓▓▓▓▓▓▓▓▓▓▓▓  ▓
▓                         ▓  ▓
▓  ▓▓▓▓▓▓▓▓▓▓▓▓▓▓▓▓▓▓▓▓▓  ▓  ▓
▓  ▓                   ▓  ▓  ▓
▓  ▓  ▓▓▓▓▓▓▓▓▓▓▓▓▓▓▓  ▓  ▓  ▓
▓  ▓  ▓            #▓  ▓  ▓  ▓
▓  ▓  ▓  ▓▓▓▓▓▓▓▓▓▓▓▓  ▓  ▓  ▓
▓  ▓  ▓                ▓  ▓  ▓
▓  ▓  ▓▓▓▓▓▓▓▓▓▓▓▓▓▓▓▓▓▓  ▓  ▓
▓  ▓                      ▓  ▓
▓  ▓▓▓▓▓▓▓▓▓▓▓▓▓▓▓▓▓▓▓▓▓▓▓▓  ▓
                              
▓ ▓▓▓▓▓▓▓▓▓▓▓▓▓▓▓▓▓▓▓▓▓▓▓▓▓▓ ▓