15
30
▓▓▓▓▓▓▓▓▓▓▓▓▓▓▓▓▓▓▓▓▓▓▓▓▓▓▓▓▓▓
▓                            ▓
▓                            ▓
▓                            ▓
▓  ▓▓▓▓▓▓▓▓▓▓▓▓▓▓▓▓▓▓▓▓▓▓▓▓  ▓
▓              ▓             ▓
▓              ▓▓▓ ▓▓ ▓▓▓▓▓▓▓▓
▓   Press 'Escape' to exit.  ▓
▓                            ▓
▓                            ▓
▓                            ▓
▓                            ▓
▓                            ▓
▓                            ▓
▓▓▓▓▓▓▓▓▓▓▓▓▓▓▓▓▓▓▓▓▓▓▓▓▓▓▓▓▓▓